tropical = {

}

arid = {
	662 151 150 147 148 654 233 332 334 152 109 555 554 556 441 440 551 552 553 557 560 442 559 445 558 636 635 641 640 639 638 637 444 448 446 443 272 653 652 651 650 450 649 647 648 646 645 447 454 455 449 451 452 453 494 491 488 486 487 490 489 492 493 496 498 497 499 509 502 500 516 503 505 504 508 506 507 510 512 511 514 513 515 333 72 149 537 536 534 535 533 531 475 471 474 470 469 473 468 467 472 466 461 456 457 459 465 458 460 462 463 464 138 137 136 135 130 131 132 139 142 141 143 140 146 145 144 484 483 479 476 477 480 481 478 482 485 675 433 430 431 439 435 437 436 432 438 529 528 526 527 525 517 524 523 522 521 520 519 518 434 530 617 615 616 894 895

    915 960 953 951 913 957 956 911 997 1322 1308 1325
    909 1309 908 941 907 905
    948 781 910 906 903 904 900 942 943 899 902 947 901 897 898 945 961 967 918 968 958 917 916 959 955 966 954
    1306 1307 952 950 946
    949 890 891

	2465 2466 2467 2468 2469 2470 2471 2472 2473 2474 2475 2476 2477 2478 2479 2480 2482 2483 2484 2485 2486 2487 2488 2489 2490 2491 2492 2493 2494 2495 2496 2497 2498
}

arctic = {
    667 632 633 668 669 365 358 357 631 630 625 624 629 799 800 634 798 655
    680 824 827 823 822 972 970 971 969 973 925 926 928 929s
}

mild_winter = {
	3 4 5 11 14 19 20 21 30 31 39 40 41 42 43 44 65 68 69 70 71 101 110 111 112 113 114 115 116 117 118 119 120 121 122 154 155 156 157 158 159 178 179 180 181 182 183 184 185 186 187 188 189 190 191 192 193 194 195 196 197 198 200 201 202 203 204 205 206 207 208 209 210 211 212 213 214 215 216 217 218 219 220 221 222 223 224 225 226 227 228 229 230 231 232 235 273 274 275 276 278 279 280 281 282 284 329 330 368 374 375 378 379 386 387 388 391 392 393 394 395 396 397 406 407 408 410 411 412 413 421 429 566 569 575 576 656 671 677 819 821 887 930 933

    98 1584 1585 1588 1587
    1606 1594 1591 1589 1590
    1604 1597 1605 1596 1595
    1601 1599 1598 1602 1603
    2073 2066 1612 2072 2069
    1611 2067 1610 1609
    1734 1735 1608 1607 1583
    1582 1723 1730 1729 1814
    1780 1781 1821
    1738 1726 1722 1725 1724
    1740 1741 1733 1736 1737
    1728 2032 2033 1739 1727
    1816 1815 1820 1819 1824
    1823 1830 1829 1832 
    2030 2029 1812 1813 2031
    1809 1808 1822 1818 1817
    1887 1890 1888 1891 1807
    1838 1837 1831 1835 1839
    1892 1806 1865 1864 1893
    1863 1862 1869 1867 1868
    1897 1895 1894 1896 1889 
    1923 1918 1917 1905 1906 
    1916 1922 1915 1804 1805
    1710 1711 1857 1712 1914
    1713 1856 1858 1859 1860
    1855 1714 1854
    1870 1861 1871
    1872 1866 1843
    1492 1491 1490
    1487 1484 1485 1488 1486 1489
    1398 1402 1408 1397 1396
    1407 1409 1410 1411
    1478 1477 1476 1472 1470
    1482 1483 1479 1480 1481
    1417 1416 1471 1418 1473
    1469 1468 1467 1445 1446
    1428 1475 1474 1427 1429
    1434 1433 1432 1431 1430
    1440 1439 1437 1436 1435
    1442 1441 1444 1443 1438

    932 931

	2499 2500 2501 2502 2503 2504 2505 2506 2508 2517 2518 2570 2571 2572 2576 2633 2649 2650 2651 2678 2679
}

normal_winter = {
	73 74 75 76 77 78 79 80 81 82 83 84 85 86 87 88 89 90 91 92 93 94 95 96 97 99 100 102 103 104 105 106 107 108 160 161 162 163 164 165 166 167 168 169 170 171 172 173 174 175 176 177 234 236 242 243 244 246 247 248 251 253 254 255 256 257 258 259 263 264 265 266 267 268 269 270 271 283 286 287 288 289 290 291 293 294 295 296 297 298 304 305 306 307 308 309 310 311 312 313 314 315 316 317 318 319 320 321 322 323 324 325 328 331 335 336 337 338 339 340 341 342 343 344 345 346 347 348 349 350 351 352 353 354 355 356 359 362 363 364 369 371 372 373 376 377 380 381 383 384 385 389 398 399 400 401 402 403 414 415 416 417 423 424 425 538 539 540 541 542 543 544 545 546 547 549 550 561 562 563 564 565 571 581 583 584 657 658 659 660 661 664 665 670 685 686 687 688 689 690 776 777 811 812 813 815 816 817 818 828 829 831 886 987 923 988  

    382 1581 1769 1721 1732 1731
    1775 1779 1778 1299 1777 1774 1776 1745 1744
    1825 1743 1826 1794 1793 1827 1828 1834 1833 1791 1836 1840 1842 1790 1789 1841 1844 1846 1851 1850 1852 1853 1848 1847 1545 1494 1495 1543 1546 1845 1849 1544 1542 1496 1497 1498 1499 1520 1521 
    1519 1493 1466 1465 1449 1447 1448 1451 1452 1450 1454 1453 1455 1464
    1463 1456 1457 1462 1461 
    1460 1458 1459 1522 1523
    1742 1586 1279 1280 1275 1276 1277 1278 1281 1282

	2507 2509 2510 2511 2512 2513 2514 2515 2516 2519 2520 2521 2522 2523 2524 2525½ 2566 2567 2568 2569 2573 2574 2575
	2526 2527 2528 2529 2530 2533 2534 2541 2542 2543 2544 2545 2546 2547 2548 2549 2550 2551 2552 2555 2554 2556 2557 2558 2559 2560 2561 2565 2577 2578 2579 2580 2581 2582 2583 2584
	2585 2586 2587 2588 2589 2590 2591 2592 2593 2594 2595 2598 2608 2609 2610 2611 2612 2613 2614 2615 2616 2617 2618 2619 2620 2621 2622 2623 2624 2625 2626 2627 2632 2658
	2628 2629 2630 2631 2660 2661 2662 2663 2664 2665 2666 2667 
}

severe_winter = {
	237 238 239 245 249 250 260 261 262 285 292 299 300 301 303 326 327 357 358 360 361 365 366 370 404 405 418 419 420 548 570 572 573 574 619 620 621 622 623 624 625 626 627 628 629 630 631 632 633 634 642 655 666 667 668 669 672 673 674 676 678 679 680 681 682 683 684 783 784 798 799 800 801 802 803 804 805 806 807 808 809 810 814 820 822 823 824 825 826 827 881 882 883 884 885 888 889 896 972 970 971 925 926 927 928 969 973 974 975 999 929 940 

    1578 1577
    1570 1768 1571 1572 1573
    1574 1575 1576 1579 1580
    1764 1760 1759 1568 1569 
    1756 1757 1567 1566 1565
    1772 1767 1770 1773 1771
    1758 1761 1766 1765 1762
    1749 1750 1763 1751 1748
    1797 1796 1795 1746 1747
    1792 1801 1800 1799 1798
    1752 1753 1564 1754 1755
    1563 1562 1561 1782 1783
    1558 1555 1554 1553 1552
    1557 1784 1560 1556 1559
    1547 1550 1548 1788 1551
    1803 1787 1786 1785 1802

    1541 1540
    1539
    1538 1537 1536 1535 1534
    1530 1531 1532 1533 1529
    1528 1527 1526 1524 1525
    1512 1511 1510 1509 1508
    1500 1513 1507 1506 1505
    1516 1517 1518 1515 1514
    1503 1502 1501 1504

    1593 1592
    1656 1655 1654 1653 1662 1663
    1649 1650 1651 1652
    1661 1660 1659 1658 1657

	2531 2532 2535 2536 2537 2538 2539 2540 2553 2562 2563 2564 2596 2597 2599 2600 2601 2602 2603 2604 2605 2606 2607
	2668 2669 2670 2671 2672 2673 2674 2675 2676 2677
}

impassable = {
	809 830 831 832 833 834 835 836 837 240 241 838 839 840 841 842 843 844 845 846 847 848 849 850 851 852 853 853 854 855 856 857 858 859 860 861 862 863 864 865 866 867 868 869 870 871 872 873 874 875 876 877 878 879 880 912 1241 1242 1243 1244 1245 1246

    1299
    2409 2408 2680
}
